; The file must be in UTF-8.
; The = sign is used, but there must be no spaces between the word and its pronunciation: spaces separate individual words in collocation entries
marketing=márketin
spotify=spótifai
apple=ápol
pi(zz=ts)a
home=joum
(i=í)nstagram
t(e=é)legram
(a=á)ndroid
(a=á)mazon
l(i=í)nux
w(i=í)ndow{,s}
high=jay
tw(it=í)ter
ed(ge=ch)
messenger=mésenller
bluetoot=blutut
google=gúguel
facebook=féisbuk
z(oo=u)m
w(i=ai)f(i=ái)
pl(a=e)y
mozilla=mocila
youtube=yutub
t(ea=i)m
m(i=ái)crosoft
(mail=meyl){,s}
chrome=croum
chromebook=cróumbuk
scr(ee=i)n
gmail=llimeil
(h=j)otm(a=e)il
office=ófis
v(ie=í)wer
game=gueim
pages=peidchs
store=stor
brai(ll=l)e
mouse=maus
IPhone=áifon
(i=ái)pad
whatsapp=whatsap
gym=llim
f(ile=ail){,s}
charlie=charli
sp(ee=i)ch
(ju=yú)nior{,s}
live=laiv
lite=lait
phone=foun
r(ea=í)der
p(y=ai)thon
fr(eu=oy)d
ok=okey
excel/1
p(o=á)wer
software=sóftuer
hardware=járduer
voice=vois
méxico=méjico
mexicano=mejicano
mexicana=mejicana
mexicanos=mejicanos
mexicanas=mejicanas
; These are old, but inportant spellings, AKA grafías in Spanish, because those are still used a lot.
texas=tejas
me(x=j)ía
(x=j)iménez
(x=j)imena
oa(x=j)aca
(x=j)alapa
; initialisms:
cpu/i
gpu/i
url/i
nvda/i
ocds/i
ald/i
imc/i
ibm/i
ocr/i
oms/i
usb/i
cne/i
xos/i
api/i